#######
#     #
# .$. #
#  @  #
#     #
#######
;2
