########
#      #
# .#$   #
#  #    #
#  @   #
#      #
########
;2