########
#      #
# . $  #
#      #
#  @   #
#  . $ #
########
;2