    ######               ####
#####*#  #################  ##
#   ###                      #
#        ########  ####  ##  #
### ####     #  ####  ####  ##
#*# # .# # # #     #     #   #
#*# #  #     # ##  # ##  ##  #
###    ### ###  # ##  # ##  ##
 #   # #*#      #     # #    #
 #   # ###  #####  #### #    #
 #####   #####  ####### ######
 #   # # #**#               #
## # #   #**#  #######  ##  #
#    #########  #    ##### ###
# #             # $        #*#
#   #########  ### @#####  #*#
#####       #### ####   ######
;2
