#######
#     #
# .   #
#   $ #
#  @  #
#     #
#######
;1
