#######
#   . #
#     #
# $   #
#  @  #
#     #
#######
;1
